墙墙墙墙墙墙墙墙墙墙墙墙墙墙墙墙墙墙墙墙墙墙墙墙墙墙墙墙墙墙墙墙墙墙墙墙墙墙墙墙墙墙墙墙墙墙墙墙墙墙墙墙墙墙墙墙墙
墙墙墙墙墙墙墙墙墙墙墙墙墙墙墙墙墙墙墙墙墙墙墙墙墙墙墙墙墙墙墙墙墙墙墙墙墙墙墙墙墙墙墙墙墙墙墙墙墙墙墙墙墙墙墙墙墙
墙墙墙墙墙墙墙墙墙墙墙墙墙墙墙墙墙墙墙墙墙墙墙墙墙墙墙墙墙墙墙墙墙墙墙墙墙墙墙墙墙墙墙墙墙墙墙墙墙墙墙墙墙墙墙墙墙
墙墙墙墙墙墙墙墙墙墙墙墙墙墙墙墙墙墙墙墙墙墙墙墙墙墙墙墙墙墙墙墙墙墙墙墙墙墙墙墙墙墙墙墙墙墙墙墙墙墙墙墙墙墙墙墙墙
墙墙墙墙墙墙墙墙墙墙墙墙墙墙墙墙墙墙墙墙墙墙墙墙墙墙墙墙墙墙墙墙墙墙墙墙墙墙墙墙墙墙墙墙墙墙墙墙墙墙墙墙墙墙墙墙墙
墙墙墙墙墙墙墙墙墙墙墙墙墙墙墙墙墙墙墙墙墙墙墙墙墙墙墙墙墙墙墙墙墙墙墙墙墙墙墙墙墙墙墙墙墙墙墙墙墙墙墙墙墙墙墙墙墙
墙墙墙墙墙墙墙墙墙墙墙墙墙墙墙墙墙墙墙墙墙墙墙墙墙墙墙墙墙墙墙墙空空空空空墙墙墙墙墙墙墙墙墙墙墙墙墙墙墙墙墙墙墙墙
墙墙墙墙墙墙墙墙墙墙墙墙墙墙墙墙墙墙墙墙墙墙墙墙墙墙墙墙墙墙墙墙空墙空墙空墙墙墙墙墙墙墙墙墙墙墙墙墙墙墙墙墙墙墙墙
墙墙墙墙墙墙墙墙墙墙墙墙墙墙墙墙墙墙墙墙墙墙墙墙墙墙墙墙黑黑空空空空空墙空墙墙墙墙墙墙墙墙墙墙墙墙墙墙墙墙墙墙墙墙
墙墙墙墙墙墙墙墙墙墙墙墙墙墙墙墙墙墙墙墙墙墙墙墙墙墙墙墙黑墙空墙墙墙墙墙树墙墙墙墙墙墙墙墙墙墙墙墙墙墙墙墙墙墙墙墙
墙墙墙墙墙墙墙墙墙墙墙墙墙墙墙墙空墙空空空墙黑黑黑黑黑黑黑墙空空空熔空空空墙墙墙墙墙墙墙墙墙墙墙墙墙墙墙墙墙墙墙墙
墙墙墙墙墙墙墙墙墙墙墙墙墙墙墙墙空墙空墙空墙黑墙墙墙墙墙墙墙空空路路路箱空墙墙墙墙墙墙墙墙墙墙墙墙墙墙墙墙墙墙墙墙
墙墙墙墙墙墙墙墙墙墙墙墙墙墙墙墙空空空墙墙墙空空空墙空空空空空空路熔空空空墙墙墙墙墙墙墙墙墙墙墙墙墙墙墙墙墙墙墙墙
墙墙墙墙墙墙墙墙墙墙墙墙墙墙空熔熔熔熔熔墙墙空墙空墙墙墙墙墙墙墙路熔墙墙墙墙墙墙墙墙墙墙墙墙墙墙墙墙墙墙墙墙墙墙墙
墙墙墙墙墙墙墙墙墙墙墙墙墙墙空熔熔熔熔熔墙墙空墙空空空空空墙树路路空空空空熔墙墙墙墙墙墙墙墙墙墙墙墙墙墙墙墙墙墙墙
墙墙墙墙墙墙墙墙墙墙墙墙墙墙空熔熔熔熔熔墙墙空墙墙墙墙墙空墙路墙墙墙墙墙空熔熔墙墙墙墙墙墙墙墙墙墙墙墙墙墙墙墙墙墙
墙墙墙墙墙墙墙墙墙墙墙墙墙墙空空空熔熔熔墙墙空空空空空墙空空路墙空墙空空空熔熔熔熔墙墙墙墙墙墙墙墙墙墙墙墙墙墙墙墙
墙墙墙墙墙墙墙墙墙墙墙墙墙墙墙墙空空空熔墙墙空空空起空墙空空路墙空墙空墙熔熔熔熔熔熔墙墙墙墙墙墙墙墙墙墙墙墙墙墙墙
墙墙墙墙墙墙墙墙墙墙黑黑黑黑黑墙空空空熔墙墙空空空空空空空空路墙空空空墙空熔空空空熔空墙墙空空墙墙墙墙墙墙墙墙墙墙
墙墙墙墙墙墙墙墙墙墙黑墙墙墙空墙空空空墙墙墙墙墙墙墙墙墙空空路墙空墙墙墙空墙空墙空墙空裂墙空空墙墙墙墙墙墙墙墙墙墙
墙墙墙墙墙墙熔熔空墙树墙空墙空空空空空墙空空空空空墙树空空空路墙空墙空空空墙空墙空墙空墙墙空空墙墙墙墙墙墙墙墙墙墙
墙墙墙墙墙墙熔熔空墙空墙空墙空墙墙墙墙墙墙墙空墙空墙墙墙空墙路墙空空空墙墙墙空墙空墙空墙墙墙墙墙墙墙墙墙墙墙墙墙墙
墙墙墙墙墙墙熔熔空空空墙空空空空空空空墙空墙空墙空墙墙墙空墙路墙墙墙墙墙空空空墙空空空墙墙墙墙墙墙墙墙墙墙墙墙墙墙
墙墙墙墙墙墙熔熔熔熔熔熔熔墙墙墙墙墙空墙空空空墙空墙墙墙空墙路空空空空墙空墙墙墙墙墙空墙墙墙墙墙墙墙墙墙墙墙墙墙墙
墙墙墙墙墙墙墙熔熔熔熔熔熔熔熔熔熔墙空空空空空墙空空空空空墙路路路空空空空空空墙空空空空空空空墙墙墙墙墙墙墙墙墙墙
墙墙墙墙墙墙墙墙墙墙墙墙熔熔熔熔熔熔熔墙空墙墙墙墙墙墙墙墙墙空墙路墙墙墙墙墙空墙墙墙空墙墙墙墙墙墙墙墙墙墙墙墙墙墙
墙墙墙墙墙墙墙墙墙墙墙墙空空空熔熔熔熔空空空空墙空空空空空空空墙路熔熔熔黑黑空墙空空空空空空空空空空空墙墙墙墙墙墙
墙墙墙墙墙墙墙墙墙墙墙墙墙墙墙墙墙熔熔熔空空空墙空墙空空空空空黑路黑黑黑黑墙墙墙墙墙空墙墙墙墙墙墙墙空墙墙墙墙墙墙
墙墙墙墙墙墙墙墙墙墙墙墙墙墙墙墙墙熔熔熔熔空空墙空墙空空空空空墙路熔熔熔黑黑黑黑黑黑黑黑空空空墙空空空墙墙墙墙墙墙
墙墙墙墙墙墙墙墙墙墙墙墙墙墙墙墙墙墙熔熔熔空空墙空墙墙墙墙墙黑墙路墙墙墙墙墙墙墙空墙空墙空箱空墙空墙墙墙墙墙墙墙墙
墙墙墙墙墙墙墙墙墙墙墙墙墙墙墙墙墙墙熔熔熔空空空空墙黑黑黑墙黑墙路路路路墙墙空空空墙空墙空空空墙空空空墙墙墙墙墙墙
墙墙墙墙墙墙墙墙墙墙墙墙墙墙墙墙墙墙熔熔熔熔空墙空墙黑墙黑墙黑墙墙墙墙路墙墙空墙墙墙墙墙墙墙空墙墙墙空墙墙墙墙墙墙
墙墙墙墙墙墙墙墙墙墙墙墙墙墙墙墙墙墙墙墙墙墙树墙黑黑黑墙黑墙黑墙空路路路空墙空墙墙墙墙墙墙墙空空空空空墙墙墙墙墙墙
墙墙墙墙墙墙墙墙墙墙墙墙墙墙墙墙墙墙空空空空箱墙墙墙墙墙黑墙黑墙墙路墙墙墙墙空墙墙墙墙墙墙墙墙墙墙墙墙墙墙墙墙墙墙
墙墙墙墙墙墙墙墙墙墙墙墙墙墙墙墙墙墙树树空树树墙黑黑黑黑黑黑黑墙路路空树黑墙空墙墙墙墙墙墙墙墙墙墙墙墙墙墙墙墙墙墙
墙墙墙墙墙墙墙墙墙墙墙墙墙墙墙墙墙墙空空空树空黑黑墙墙墙墙墙墙墙路墙墙墙墙墙空墙墙墙墙墙墙墙墙墙墙墙墙墙墙墙墙墙墙
墙墙墙墙墙墙墙墙墙墙墙墙墙墙墙墙墙墙空树树树空墙墙墙空空空空空空路墙路路路墙空墙墙墙墙墙墙墙墙墙墙墙墙墙墙墙墙墙墙
墙墙墙墙墙墙墙墙墙墙墙墙墙墙墙墙墙墙空空空空空墙墙墙裂墙墙墙空墙路墙路墙路墙空墙墙墙墙墙墙墙墙墙墙墙墙墙墙墙墙墙墙
墙墙墙墙墙墙墙墙墙墙墙墙墙墙墙墙墙墙墙墙墙墙墙墙墙空空空墙墙树墙路路路墙路墙空空空墙墙墙墙墙墙墙墙墙墙墙墙墙墙墙墙
墙墙墙墙墙墙墙墙墙墙墙墙墙墙墙墙墙墙墙墙墙墙墙墙空墙空墙空墙墙墙墙墙墙墙路墙墙墙墙墙墙墙墙墙墙墙墙墙墙墙墙墙墙墙墙
墙墙墙墙墙墙墙墙墙墙墙墙墙墙墙墙墙墙墙墙墙墙墙墙空空箱路路路路路路路路路路墙墙墙墙墙墙墙墙墙墙墙墙墙墙墙墙墙墙墙墙
墙墙墙墙墙墙墙墙墙墙墙墙墙墙墙墙墙墙墙墙墙墙墙墙空墙空墙空墙墙墙空墙空墙墙墙墙墙墙墙墙墙墙墙墙墙墙墙墙墙墙墙墙墙墙
墙墙墙墙墙墙墙墙墙墙墙墙墙墙墙墙墙墙墙墙墙墙墙墙墙空空空墙墙空空空墙空墙墙墙墙墙墙墙墙墙墙墙墙墙墙墙墙墙墙墙墙墙墙
墙墙墙墙墙墙墙墙墙墙墙墙墙墙墙墙墙墙墙墙墙墙墙墙墙墙墙墙墙墙墙墙墙墙墙墙墙墙墙墙墙墙墙墙墙墙墙墙墙墙墙墙墙墙墙墙墙
墙墙墙墙墙墙墙墙墙墙墙墙墙墙墙墙墙墙墙墙墙墙墙墙墙墙墙墙墙墙墙墙墙墙墙墙墙墙墙墙墙墙墙墙墙墙墙墙墙墙墙墙墙墙墙墙墙
墙墙墙墙墙墙墙墙墙墙墙墙墙墙墙墙墙墙墙墙墙墙墙墙墙墙墙墙墙墙墙墙墙墙墙墙墙墙墙墙墙墙墙墙墙墙墙墙墙墙墙墙墙墙墙墙墙
墙墙墙墙墙墙墙墙墙墙墙墙墙墙墙墙墙墙墙墙墙墙墙墙墙墙墙墙墙墙墙墙墙墙墙墙墙墙墙墙墙墙墙墙墙墙墙墙墙墙墙墙墙墙墙墙墙
墙墙墙墙墙墙墙墙墙墙墙墙墙墙墙墙墙墙墙墙墙墙墙墙墙墙墙墙墙墙墙墙墙墙墙墙墙墙墙墙墙墙墙墙墙墙墙墙墙墙墙墙墙墙墙墙墙
