墙墙墙墙墙墙墙墙墙墙墙墙墙墙墙墙墙墙墙墙墙墙墙墙墙墙墙墙墙墙墙墙墙墙墙墙墙墙墙墙墙墙墙墙墙墙墙墙墙墙墙墙墙墙墙墙墙
墙墙墙墙墙墙墙墙墙墙墙墙墙墙墙墙墙墙墙墙墙墙墙墙墙墙墙墙墙墙墙墙墙墙墙墙墙墙墙墙墙墙墙墙墙墙墙墙墙墙墙墙墙墙墙墙墙
墙墙墙墙墙墙墙墙墙墙墙墙墙墙墙墙墙墙墙墙墙墙墙墙墙墙墙墙墙墙墙墙墙墙墙墙墙墙墙墙墙墙墙墙墙墙墙墙墙墙墙墙墙墙墙墙墙
墙墙墙墙墙墙墙墙墙墙墙墙墙墙墙墙墙墙墙墙墙墙墙墙墙墙墙墙墙墙墙墙墙墙墙墙墙墙墙墙墙墙墙墙墙墙墙墙墙墙墙墙墙墙墙墙墙
墙墙墙墙墙墙墙墙墙墙墙墙墙墙墙墙墙墙墙墙墙墙墙墙墙墙墙墙墙墙墙墙墙墙墙墙墙墙墙墙墙墙墙墙墙墙墙墙墙墙墙墙墙墙墙墙墙
墙墙墙墙墙墙墙墙墙墙墙墙墙墙墙墙墙墙墙墙墙墙墙墙墙墙墙墙墙墙墙墙墙墙墙墙墙墙墙墙墙墙墙墙墙墙墙墙墙墙墙墙墙墙墙墙墙
墙墙墙墙墙墙墙墙墙墙墙墙墙墙墙墙墙墙墙墙墙墙墙墙墙墙墙墙墙墙墙墙空空空空空墙墙墙墙墙墙墙墙墙墙墙墙墙墙墙墙墙墙墙墙
墙墙墙墙墙墙墙墙墙墙墙墙墙墙墙墙墙墙墙墙墙墙墙墙墙墙墙墙墙墙墙墙空墙空墙空墙墙墙墙墙墙墙墙墙墙墙墙墙墙墙墙墙墙墙墙
墙墙墙墙墙墙墙墙墙墙墙墙墙墙墙墙墙墙墙墙墙墙墙墙墙墙墙墙黑黑空空空空空墙空墙墙墙墙墙墙墙墙墙墙墙墙墙墙墙墙墙墙墙墙
墙墙墙墙墙墙墙墙墙墙墙墙墙墙墙墙墙墙墙墙墙墙墙墙墙墙墙墙黑墙空墙墙墙墙墙树墙墙墙墙墙墙墙墙墙墙墙墙墙墙墙墙墙墙墙墙
墙墙墙墙墙墙墙墙墙墙墙墙墙墙墙墙空墙空空空墙黑黑黑黑黑黑黑墙空空空熔空空空墙墙墙墙墙墙墙墙墙墙墙墙墙墙墙墙墙墙墙墙
墙墙墙墙墙墙墙墙墙墙墙墙墙墙墙墙空墙空墙空墙黑墙墙墙墙墙墙墙空空熔熔空箱空墙墙墙墙墙墙墙墙墙墙墙墙墙墙墙墙墙墙墙墙
墙墙墙墙墙墙墙墙墙墙墙墙墙墙墙墙空空空墙墙墙空空空墙空空空空空空熔熔空空空墙墙墙墙墙墙墙墙墙墙墙墙墙墙墙墙墙墙墙墙
墙墙墙墙墙墙墙墙墙墙墙墙墙墙空熔熔熔熔熔墙墙空墙空墙墙墙墙墙墙墙熔熔墙墙墙墙墙墙墙墙墙墙墙墙墙墙墙墙墙墙墙墙墙墙墙
墙墙墙墙墙墙墙墙墙墙墙墙墙墙空熔熔熔熔熔墙墙空墙空空空空空墙树空空空空空空熔墙墙墙墙墙墙墙墙墙墙墙墙墙墙墙墙墙墙墙
墙墙墙墙墙墙墙墙墙墙墙墙墙墙空熔熔熔熔熔墙墙空墙墙墙墙墙空墙空墙墙墙墙墙空熔熔墙墙墙墙墙墙墙墙墙墙墙墙墙墙墙墙墙墙
墙墙墙墙墙墙墙墙墙墙墙墙墙墙空空空熔熔熔墙墙空空空空空墙空空空墙空墙空空空熔熔熔熔墙墙墙墙墙墙墙墙墙墙墙墙墙墙墙墙
墙墙墙墙墙墙墙墙墙墙墙墙墙墙墙墙空空空熔墙墙空空空起空墙空空空墙空墙空墙熔熔熔熔熔熔墙墙墙问问墙墙墙墙墙墙墙墙墙墙
墙墙墙墙墙墙墙墙墙墙黑黑黑黑黑墙空空空熔墙墙空空空空空空空空空墙空空空墙空熔空空空熔空墙墙空问问问墙墙墙墙墙墙墙墙
墙墙墙墙墙墙墙墙墙墙黑墙墙墙空墙空空空墙墙墙墙墙墙墙墙墙空空空墙空墙墙墙空墙空墙空墙路裂裂空问问问墙墙墙墙墙墙墙墙
墙墙墙墙墙墙熔熔空墙树墙空墙空空空空空墙空空空空空墙树空空空空墙空墙空空空墙空墙空墙路墙墙空问问问墙墙墙墙墙墙墙墙
墙墙墙墙墙墙熔熔空墙空墙空墙空墙墙墙墙墙墙墙空墙空墙墙墙空墙空墙空空空墙墙墙空墙空墙路墙墙问问问问问问墙墙墙墙墙墙
墙墙墙墙墙墙熔熔空空空墙空空空空空空空墙空墙空墙空墙墙墙空墙树墙墙墙墙墙空空空墙空空路墙墙墙墙墙墙墙问墙墙墙墙墙墙
墙墙墙墙墙墙熔熔熔熔熔熔熔墙墙墙墙墙空墙空空空墙空墙墙墙空墙空空空空空墙空墙墙墙墙墙路墙墙墙墙墙墙墙墙墙墙墙墙墙墙
墙墙墙墙墙墙墙熔熔熔熔熔熔熔熔熔熔墙空空空空空墙空空空空空墙空空空空空空空空空墙空空路空空空空墙墙墙墙墙墙墙墙墙墙
墙墙墙墙墙墙墙墙墙墙墙墙熔熔熔熔熔熔熔墙空墙墙墙墙墙墙墙墙墙空墙熔墙墙墙墙墙空墙墙墙路墙墙墙墙墙墙墙墙墙墙墙墙墙墙
墙墙墙墙墙墙墙墙墙墙墙墙空空空熔熔熔熔空空空空墙空空空空空空空墙熔熔熔熔黑黑空墙空空路空空空空空空空空墙墙墙墙墙墙
墙墙墙墙墙墙墙墙墙墙墙墙墙墙墙墙墙熔熔熔空空空墙空墙空空空空空黑黑黑黑黑黑墙墙墙墙墙路墙墙墙墙墙墙墙空墙墙墙墙墙墙
墙墙墙墙墙墙墙墙墙墙墙墙墙墙墙墙墙熔熔熔熔空空墙空墙空空空空空墙路路路路路路路路路路路黑空空空墙空空空墙墙墙墙墙墙
墙墙墙墙墙墙墙墙墙墙墙墙墙墙墙墙墙墙熔熔熔空空墙空墙墙墙墙墙黑墙路墙墙墙墙墙墙墙空墙空墙空箱空墙空墙墙墙墙墙墙墙墙
墙墙墙墙墙墙墙墙墙墙墙墙墙墙墙墙墙墙熔熔熔空空空空墙黑黑黑墙黑墙路路路路墙墙空空空墙空墙空空空墙空空空墙墙墙墙墙墙
墙墙墙墙墙墙墙墙墙墙墙墙墙墙墙墙墙墙熔熔熔熔空墙空墙黑墙黑墙黑墙墙墙墙路墙墙空墙墙墙墙墙墙墙空墙墙墙空墙墙墙墙墙墙
墙墙墙墙墙墙墙墙墙墙墙墙墙墙墙墙墙墙墙墙墙墙树墙黑黑黑墙黑墙黑墙空路路路空墙空墙墙墙墙墙墙墙空空空空空墙墙墙墙墙墙
墙墙墙墙墙墙墙墙墙墙墙墙墙墙墙墙墙墙空空空空箱墙墙墙墙墙黑墙黑墙墙路墙墙墙墙空墙墙墙墙墙墙墙墙墙墙墙墙墙墙墙墙墙墙
墙墙墙墙墙墙墙墙墙墙墙墙墙墙墙墙墙墙树树空树树墙黑黑黑黑黑黑黑墙路路空树黑墙空墙墙墙墙墙墙墙墙墙墙墙墙墙墙墙墙墙墙
墙墙墙墙墙墙墙墙墙墙墙墙墙墙墙墙墙墙空空空树空黑黑墙墙墙墙墙墙墙路墙墙墙墙墙空墙墙墙墙墙墙墙墙墙墙墙墙墙墙墙墙墙墙
墙墙墙墙墙墙墙墙墙墙墙墙墙墙墙墙墙墙空树树树空墙墙墙空空空空空空路墙路路路墙空墙墙墙墙墙墙墙墙墙墙墙墙墙墙墙墙墙墙
墙墙墙墙墙墙墙墙墙墙墙墙墙墙墙墙墙墙空空空空空墙墙墙裂墙墙墙空墙路墙路墙路墙空墙墙墙墙墙墙墙墙墙墙墙墙墙墙墙墙墙墙
墙墙墙墙墙墙墙墙墙墙墙墙墙墙墙墙墙墙墙墙墙墙墙墙墙空空空墙墙树墙路路路墙路墙空空空墙墙墙墙墙墙墙墙墙墙墙墙墙墙墙墙
墙墙墙墙墙墙墙墙墙墙墙墙墙墙墙墙墙墙墙墙墙墙墙墙空墙空墙空墙墙墙墙墙墙墙路墙墙墙墙墙墙墙墙墙墙墙墙墙墙墙墙墙墙墙墙
墙墙墙墙墙墙墙墙墙墙墙墙墙墙墙墙墙墙墙墙墙墙墙墙空空箱路路路路路路路路路路墙墙墙墙墙墙墙墙墙墙墙墙墙墙墙墙墙墙墙墙
墙墙墙墙墙墙墙墙墙墙墙墙墙墙墙墙墙墙墙墙墙墙墙墙空墙空墙空墙墙墙空墙空墙墙墙墙墙墙墙墙墙墙墙墙墙墙墙墙墙墙墙墙墙墙
墙墙墙墙墙墙墙墙墙墙墙墙墙墙墙墙墙墙墙墙墙墙墙墙墙空空空墙墙空空空墙空墙墙墙墙墙墙墙墙墙墙墙墙墙墙墙墙墙墙墙墙墙墙
墙墙墙墙墙墙墙墙墙墙墙墙墙墙墙墙墙墙墙墙墙墙墙墙墙墙墙墙墙墙墙墙墙墙墙墙墙墙墙墙墙墙墙墙墙墙墙墙墙墙墙墙墙墙墙墙墙
墙墙墙墙墙墙墙墙墙墙墙墙墙墙墙墙墙墙墙墙墙墙墙墙墙墙墙墙墙墙墙墙墙墙墙墙墙墙墙墙墙墙墙墙墙墙墙墙墙墙墙墙墙墙墙墙墙
墙墙墙墙墙墙墙墙墙墙墙墙墙墙墙墙墙墙墙墙墙墙墙墙墙墙墙墙墙墙墙墙墙墙墙墙墙墙墙墙墙墙墙墙墙墙墙墙墙墙墙墙墙墙墙墙墙
墙墙墙墙墙墙墙墙墙墙墙墙墙墙墙墙墙墙墙墙墙墙墙墙墙墙墙墙墙墙墙墙墙墙墙墙墙墙墙墙墙墙墙墙墙墙墙墙墙墙墙墙墙墙墙墙墙
墙墙墙墙墙墙墙墙墙墙墙墙墙墙墙墙墙墙墙墙墙墙墙墙墙墙墙墙墙墙墙墙墙墙墙墙墙墙墙墙墙墙墙墙墙墙墙墙墙墙墙墙墙墙墙墙墙
